{
  "layer0": [
    2, 2, 2, 2, 2, 2, 2, 2, 2, 2, 2, 2, 2, 2, 2,
    2, 2, 2, 2, 2, 2, 2, 2, 2, 2, 2, 2, 2, 2, 2,
    2, 2, 2, 2, 2, 2, 2, 2, 2, 2, 2, 2, 2, 2, 2,
    2, 2, 2, 2, 2, 2, 2, 2, 2, 2, 2, 2, 2, 2, 2,
    2, 2, 2, 2, 2, 2, 2, 2, 2, 2, 2, 2, 2, 2, 2,
    2, 2, 2, 2, 2, 2, 2, 2, 2, 2, 2, 2, 2, 2, 2,
    2, 2, 2, 2, 2, 2, 2, 2, 2, 2, 2, 2, 2, 2, 2,
    2, 2, 2, 2, 2, 2, 2, 2, 2, 2, 2, 2, 2, 2, 2,
    2, 2, 2, 2, 2, 2, 2, 2, 2, 2, 2, 2, 2, 2, 2,
    2, 2, 2, 2, 2, 2, 2, 2, 2, 2, 2, 2, 2, 2, 2
  ],
  "layer1": [
   63,50,50,50,50,50,50,50,50,50,50,50,50,50,60,
   56, 0, 0, 0, 0, 0, 0, 0, 0, 0, 0, 0, 0, 0,52,
   56, 0, 0, 0, 0, 0, 0, 0, 0, 0, 0, 0, 0, 0,52,
   56, 0, 0, 0, 0, 0, 0, 0, 0, 0, 0, 0, 0, 0,52,
   56, 0, 0, 0, 0, 0, 0, 0, 0, 0, 0, 0, 0, 0,52,
   56, 0, 0, 0, 0, 0, 0, 0, 0, 0, 0, 0, 0, 0,52,
   56, 0, 0, 0, 0, 0, 0, 0, 0, 0, 0, 0, 0, 0,52,
   56, 0, 0, 0, 0, 0, 0, 0, 0, 0, 0, 0, 0, 0,52,
   56, 0, 0, 0, 0, 0, 0, 0, 0, 0, 0, 0, 0, 0,52,
   62,54,54,54,54,54,54,54,54,54,54,54,54,54,61
  ],
  "layer2": [
    0, 0, 0, 0, 0, 0, 0, 0, 0, 0, 0, 0, 0, 0, 0,
    0, 0, 0, 0, 0, 0, 0, 0, 0, 0, 0, 0, 0, 0, 0,
    0, 0, 0, 0, 0, 0, 0, 0, 0, 0, 0, 0, 0, 0, 0,
    0, 0, 0, 0, 0, 0, 0, 0, 0, 0, 0, 0, 0, 0, 0,
    0, 0, 0, 0, 0, 0, 0, 0, 0, 0, 0, 0, 0, 0, 0,
    0, 0, 0, 0, 0, 0, 0, 0, 0, 0, 0, 0, 0, 0, 0,
    0, 0, 0, 0, 0, 0, 0, 0, 0, 0, 0, 0, 0, 0, 0,
    0, 0, 0, 0, 0, 0, 0, 0, 0, 0, 0, 0, 0, 0, 0,
    0, 0, 0, 0, 0, 0, 0, 0, 0, 0, 0, 0, 0, 0, 0,
    0, 0, 0, 0, 0, 0, 0, 0, 0, 0, 0, 0, 0, 0, 0
  ]
}